1111111111111111111111111
1010001010000000001000101
1000100010111110101010101
1011111000000011101010001
1010001111111001001011101
1010101001001011011010001
1000111101011001000010101
1110100000001101111111101
1000101110100001010000001
1010100011111011000111111
1111111010100001010000001
1000100010111111111111101
1010101110001010100001001
1010101010100000111101011
1010101011111010101000001
1010001001000010101111101
1010111100010110101010001
1010100001010010000000101
1111111111111111111111111
