1111111111111111111111111
1000000000000000000000001
1000000010000000000100001
1000010000000000000000001
1000000000000000000000001
1000001000001000000100001
1001000000000000000000001
1000000010000100000000001
1000001000000000010000001
1000000000000100000000001
1000101000000000000010001
1000000000000000000000001
1000000000000010010000001
1000001000000000000000001
1000000000100000000000101
1000000100000000000000001
1000000000000000100000001
1000000000000000000000001
1111111111111111111111111
