1000000000011100000000001
0000000000000000000000000
0001001001001001001001000
0000000000000000000000000
0100000000011100000000010
0000100000000000000010000
0000000000010100000000000
0100000100010100010000010
0000000000010100000000000
0000100000011100000010000
0000000000010100000000000
0100000100010100010000010
0000000000010100000000000
0000100000000000000010000
0100000000011100000000010
0000000000000000000000000
0001001001001001001001000
0000000000000000000000000
1000000000011100000000001
